1111111111111
10001111111C1
1010000000001
1P11C1111E111
111111111111